5
I 0 0 H 0 
0 0 0 0 0 
0 0 0 0 0 
0 I 0 0 0 
0 I 0 0 0 
