5
0 I I I I 
I I I S I 
H 0 G 0 0 
0 0 I I 0 
0 0 0 I 0 
