5
G W 0 H H 
H I 0 0 0 
0 H H I 0 
H H W H 0 
0 H 0 S W 
