5
0 0 0 0 H 
H 0 S 0 0 
0 0 0 I 0 
0 0 0 0 0 
0 0 0 H G 
