5
I 0 0 0 0 
G 0 0 0 0 
H 0 0 0 0 
0 S H W H 
0 0 0 0 0 
