10
0 W 0 0 0 0 0 0 0 H 
I H 0 0 0 0 H H I W 
0 0 0 0 S I H 0 0 0 
0 0 0 W H 0 0 0 0 0 
0 0 0 0 G H 0 0 W 0 
0 0 0 0 0 I 0 0 0 0 
H 0 0 0 W 0 0 0 0 I 
0 0 W 0 0 0 0 H W 0 
0 0 0 0 W 0 0 I 0 0 
0 W 0 0 0 I 0 0 0 W 
