10
H 0 H 0 0 I 0 0 0 I 
0 0 0 0 0 0 0 0 0 0 
0 0 0 0 0 0 0 0 W 0 
0 0 I S 0 0 0 0 0 W 
0 H 0 0 0 0 0 0 0 0 
0 I 0 0 H 0 0 0 0 0 
H 0 H 0 H 0 0 G 0 0 
H H 0 0 0 0 0 0 W 0 
0 0 0 I 0 0 0 0 0 0 
0 0 I 0 W 0 0 I 0 0 
