10
0 H 0 0 0 S I 0 I 0 
0 H 0 H 0 0 0 0 W 0 
0 0 0 I 0 0 W 0 0 0 
I 0 0 I 0 0 0 W W W 
0 W 0 0 H H 0 0 H 0 
0 I I 0 0 H 0 W I 0 
0 0 0 H 0 0 H 0 0 0 
W I G H 0 H 0 0 0 0 
0 0 0 0 0 I 0 H 0 0 
H H 0 H 0 0 0 W 0 0 
