5
H 0 0 I 0 
H S W H 0 
0 0 G 0 0 
I 0 I 0 0 
0 0 0 0 0 
