5
0 0 0 0 0 
0 0 0 0 0 
0 0 0 0 0 
0 W 0 0 S 
G 0 0 0 0 
