5
0 0 0 0 I 
0 W 0 0 0 
W G 0 0 0 
0 0 0 S H 
0 I 0 0 0 
