5
W 0 I H 0 
H 0 0 I 0 
I H 0 0 I 
0 0 0 G S 
0 0 I 0 I 
