5
0 G W W I 
I 0 S W 0 
I 0 W 0 0 
W 0 0 0 I 
0 0 0 I 0 
