10
0 0 W 0 0 0 0 0 0 0 
0 0 0 0 W 0 0 0 0 0 
I 0 I 0 0 0 H 0 W 0 
0 0 W 0 0 0 0 0 W S 
0 0 0 H 0 W 0 0 0 0 
0 0 0 0 0 H 0 0 0 0 
0 0 0 0 0 0 0 0 H W 
W 0 0 0 0 0 W 0 I 0 
0 W G 0 0 0 0 I 0 0 
0 0 0 0 0 0 0 0 0 W 
