5
0 0 0 H W 
0 G 0 0 H 
0 S 0 0 W 
0 0 W 0 0 
0 0 0 0 W 
