20
0 0 H H 0 0 H 0 0 0 0 0 0 0 0 H H 0 W H 
0 W I 0 0 I H I H 0 0 0 0 H 0 0 0 0 0 0 
0 0 0 0 G 0 W H 0 0 H 0 0 0 H 0 0 0 0 0 
0 0 0 W 0 0 0 H 0 0 I 0 0 0 0 I 0 0 H W 
0 H W H 0 I 0 0 0 I W 0 0 0 0 W I 0 I I 
0 H H 0 0 0 I H 0 I 0 0 0 0 0 W 0 0 0 I 
0 H I I 0 0 0 0 0 0 0 0 I H H 0 0 I 0 0 
0 0 0 0 0 W 0 0 I 0 0 W 0 0 0 0 0 0 0 0 
H 0 0 H 0 I 0 0 0 I 0 H H I 0 0 0 0 0 0 
0 0 0 0 0 0 0 0 0 W 0 0 0 0 0 0 I 0 0 0 
0 0 H 0 0 0 H 0 0 0 0 0 0 0 0 0 W I 0 H 
0 I 0 0 0 0 0 0 0 0 0 0 0 0 0 0 I 0 0 I 
0 0 0 H 0 0 0 W H I 0 H 0 W 0 0 H 0 0 W 
0 0 0 0 0 0 H H 0 0 0 0 0 0 0 0 0 0 H 0 
0 0 H 0 W 0 0 0 0 H 0 0 0 H 0 0 0 0 W 0 
0 0 0 I 0 0 0 0 0 0 0 0 0 W 0 0 W 0 0 0 
W 0 I 0 I 0 0 0 0 H 0 0 0 0 I 0 0 0 0 0 
0 0 H S 0 0 0 0 W 0 0 0 I W 0 H 0 0 0 0 
0 I I 0 0 I 0 H 0 W 0 0 0 0 0 0 H 0 W 0 
0 0 0 0 W 0 0 0 0 0 W 0 0 0 0 0 0 0 0 0 
