5
0 W W I H 
W I 0 S 0 
0 0 0 0 I 
W 0 I 0 0 
0 G W 0 W 
