5
0 0 0 0 0 
0 0 0 0 S 
0 H 0 0 W 
0 0 I 0 0 
0 0 0 0 G 
