20
W 0 0 0 0 0 I 0 0 0 0 H 0 0 0 0 0 0 0 0 
0 H 0 H 0 0 0 0 I 0 I 0 0 W 0 0 0 0 0 0 
0 0 0 0 0 0 0 0 0 0 0 0 H 0 0 0 0 0 0 0 
I 0 0 0 H 0 I W 0 W 0 0 0 0 0 0 H 0 0 0 
0 0 0 W 0 I 0 0 H 0 0 0 H S W 0 0 0 0 0 
0 0 0 0 0 0 0 W 0 0 H 0 0 0 0 0 0 0 H 0 
0 0 0 I 0 0 0 I 0 H 0 W W I 0 H W 0 0 0 
0 0 I 0 0 0 0 0 0 H 0 I W 0 0 0 0 0 I H 
I 0 0 H 0 0 0 0 0 0 0 0 0 0 0 0 0 0 0 0 
0 I 0 0 0 0 0 0 0 0 0 0 W W 0 0 W 0 0 0 
0 0 0 0 0 0 0 0 0 0 0 0 0 0 0 0 0 H I 0 
0 0 0 0 0 0 0 W 0 0 0 0 H I 0 0 H 0 0 0 
0 H I 0 I I 0 0 G 0 0 0 0 0 0 0 W 0 H 0 
0 I 0 0 0 0 0 0 0 0 0 0 0 0 0 0 0 0 0 0 
0 0 0 0 0 0 0 0 0 0 0 0 0 0 0 0 W 0 0 0 
0 H 0 I 0 0 0 0 0 0 I H W 0 0 0 0 I 0 0 
0 0 0 0 H 0 0 0 0 0 0 0 0 0 0 0 0 0 0 0 
0 0 0 0 0 0 0 0 0 0 0 0 I 0 0 0 0 0 0 0 
0 H 0 H 0 0 0 0 0 0 0 W 0 0 I 0 0 0 0 0 
0 0 0 0 I 0 0 0 0 0 0 0 0 0 0 0 0 H 0 0 
