5
0 0 H 0 0 
0 0 0 0 G 
W S H 0 W 
0 H 0 0 0 
0 0 0 0 0 
