10
I 0 I I W W 0 0 0 0 
0 0 0 W 0 0 0 0 0 0 
W I H W 0 0 H 0 0 H 
W 0 H 0 0 0 0 H H 0 
0 0 0 0 0 I H 0 0 0 
0 0 S 0 0 I 0 0 0 0 
0 0 0 0 0 0 W W 0 0 
I 0 0 0 0 0 G I 0 0 
I 0 0 0 0 0 0 0 H 0 
0 H 0 0 0 0 0 0 0 0 
