25
0 I I 0 I 0 0 H G I W 0 0 W 0 0 0 0 0 0 0 0 0 0 0 
0 I I 0 0 0 I 0 0 I I I I 0 0 0 I 0 0 0 0 0 0 I I 
0 I 0 I 0 I 0 I 0 H 0 0 I 0 0 H I 0 0 H 0 I 0 I 0 
H 0 0 0 0 I 0 0 0 I 0 I 0 0 I 0 W 0 I I 0 H 0 0 0 
0 0 0 0 I 0 H 0 0 I 0 H 0 0 0 0 I I 0 0 0 I 0 I I 
I I 0 0 I 0 0 0 I I 0 0 0 I 0 0 0 0 0 I I I H 0 0 
0 I I I 0 0 I W H W 0 0 I 0 I 0 I 0 0 0 0 0 0 H I 
0 0 I 0 0 0 0 0 0 I I 0 0 0 0 0 I 0 0 0 H 0 0 0 I 
I I 0 I I 0 0 0 I 0 I 0 0 0 I I 0 0 0 0 H 0 0 0 W 
0 0 0 H 0 H 0 0 I 0 0 0 0 I I 0 0 0 0 I 0 0 I I I 
0 I 0 W H 0 W 0 H 0 W 0 I 0 0 0 0 I 0 0 I 0 I I I 
0 I 0 I H I W I I 0 0 0 0 0 0 0 0 0 0 W I 0 0 I 0 
0 0 I 0 I 0 I I W 0 0 0 0 0 0 0 I I I 0 I 0 I 0 0 
0 H 0 0 0 0 I 0 W I 0 0 I I W 0 0 I 0 H 0 0 0 H I 
0 0 0 W 0 0 I 0 0 0 I I 0 0 0 0 0 I 0 0 0 W 0 W 0 
W 0 I 0 0 I 0 0 I 0 H I I I 0 0 I I I 0 0 H I 0 0 
I 0 0 0 I I I 0 0 0 I 0 W 0 0 0 0 0 0 0 I I 0 I H 
0 0 I I 0 I I 0 0 0 H 0 W 0 0 0 0 H H 0 I 0 I 0 H 
0 0 0 W 0 0 I 0 0 I 0 I 0 I W H 0 0 0 I 0 0 I 0 I 
I 0 0 0 0 0 W I I I 0 I 0 0 I 0 0 0 I 0 0 0 0 I 0 
W 0 0 0 0 I 0 I 0 0 0 0 I 0 0 I 0 0 0 0 W S 0 0 I 
0 0 I I 0 0 0 0 0 I 0 0 0 0 I I I 0 0 0 H 0 0 0 I 
0 I I I 0 H 0 0 0 0 I 0 I I W 0 0 I 0 H 0 0 I I 0 
0 0 I H 0 0 I I I 0 0 I H 0 0 I I 0 0 0 0 I I H 0 
0 0 I 0 I 0 0 0 0 I 0 I 0 0 0 I 0 0 I 0 0 I I 0 0 
