15
0 0 I W 0 0 0 0 G 0 0 0 0 I 0 
0 0 H 0 W W W 0 I 0 0 H 0 H 0 
0 0 0 H 0 W 0 0 0 H 0 0 0 I H 
H 0 0 W I 0 0 0 0 0 H 0 0 H W 
0 H W H 0 0 0 0 W I 0 W 0 I H 
0 W H H 0 0 0 H 0 0 0 0 0 H 0 
I 0 0 W 0 0 I 0 I 0 0 0 0 0 0 
0 I I 0 0 0 0 0 0 H 0 0 S H W 
0 0 W I H 0 0 I 0 W I 0 0 I 0 
0 I H H I 0 H I H 0 H 0 0 0 0 
H 0 W W W 0 0 0 W H 0 0 0 0 0 
W W 0 0 0 0 0 0 I 0 0 0 0 0 0 
0 H 0 I 0 I 0 I H I W 0 0 I 0 
H 0 0 0 0 0 W W H 0 0 0 W H W 
H 0 0 W 0 0 0 0 W 0 0 0 I H I 
