5
0 0 0 0 0 
0 0 0 0 0 
0 0 0 0 0 
G 0 I S 0 
0 0 0 H 0 
