5
0 0 0 0 0 
0 I 0 0 0 
0 W 0 0 0 
0 0 0 I G 
0 0 0 0 S 
