5
I 0 I 0 H 
G W 0 W H 
H H W 0 0 
0 0 S W W 
I 0 0 H W 
