5
0 0 0 0 0 
0 0 W I 0 
0 G 0 0 0 
0 0 0 0 0 
0 0 S 0 0 
