10
0 0 0 0 0 0 S I 0 0 
0 H 0 0 0 0 0 I 0 0 
0 W I I 0 0 0 I I 0 
0 0 0 0 W 0 0 0 0 I 
H 0 0 0 H 0 0 0 0 0 
0 0 0 0 0 I 0 0 0 0 
0 0 0 0 0 0 I 0 0 0 
0 0 0 0 0 0 H 0 0 0 
0 0 0 H I 0 0 H 0 0 
0 0 0 0 0 0 G 0 0 W 
