5
0 H W 0 0 
0 I 0 0 0 
0 0 I I 0 
0 S 0 G 0 
0 0 0 0 0 
