5
0 0 0 0 H 
0 0 0 I 0 
0 0 W 0 0 
I 0 0 0 G 
S W 0 0 I 
