20
H 0 0 0 0 I 0 0 0 I 0 0 0 0 0 0 0 0 0 H 
0 0 0 0 0 0 0 0 0 0 0 W 0 0 0 H H 0 0 0 
0 0 0 0 0 0 0 0 0 0 0 0 0 0 0 0 0 0 0 W 
0 0 0 0 0 0 0 0 W 0 0 0 0 0 0 0 0 0 0 0 
H 0 0 0 0 0 0 0 W 0 0 0 0 0 0 H 0 0 0 I 
0 0 0 0 0 0 0 0 0 0 W 0 0 0 0 H 0 0 0 0 
0 I 0 0 H 0 I 0 0 0 0 I 0 0 0 0 0 0 I I 
0 0 0 0 0 0 0 0 0 0 0 0 0 0 0 0 0 0 0 0 
W 0 0 0 0 0 0 0 H H H 0 0 0 0 0 0 0 0 0 
0 0 0 0 0 0 0 H 0 0 0 S 0 H 0 0 0 0 0 0 
0 0 0 0 0 H 0 0 0 0 I 0 0 0 0 I 0 0 0 0 
0 0 0 0 0 0 I H 0 0 0 0 0 0 0 0 0 0 0 0 
H 0 0 0 0 0 0 0 0 0 H I 0 0 0 0 0 0 0 0 
0 0 0 0 W W 0 0 0 0 0 0 0 0 0 0 0 W 0 0 
0 H 0 0 0 0 0 0 0 0 W 0 0 0 0 0 0 0 0 0 
0 0 0 0 0 G 0 0 0 H 0 0 0 0 0 0 0 H 0 W 
I 0 0 0 0 0 0 H 0 0 0 0 0 0 0 0 0 0 0 0 
0 0 0 0 0 0 0 0 0 0 0 0 0 H 0 0 I 0 0 0 
0 0 0 0 I I 0 I 0 0 0 0 0 0 W 0 0 0 0 0 
H I 0 H 0 0 0 0 W 0 0 0 W 0 0 0 0 H 0 0 
