10
0 0 0 I W 0 0 0 0 0 
0 I I 0 0 0 0 0 I 0 
I 0 I 0 0 0 0 I 0 0 
I H 0 0 0 H H S 0 0 
I I W 0 0 0 I 0 I 0 
0 I 0 0 I 0 0 I I I 
0 H 0 I 0 0 I 0 W 0 
0 I H 0 0 0 W I 0 0 
0 0 0 0 H 0 0 I H I 
0 0 0 G 0 0 0 I 0 0 
