20
0 0 0 0 H 0 0 0 0 I 0 0 0 0 I 0 0 0 0 I 
0 0 0 W 0 H 0 0 0 0 0 0 S H 0 0 0 0 0 0 
I 0 0 0 0 H I G 0 0 0 0 0 0 0 0 0 0 0 I 
I 0 0 0 0 0 0 0 0 0 0 0 0 0 0 0 0 H I 0 
0 0 0 0 0 0 0 0 0 0 I I W 0 W 0 0 H 0 I 
0 I 0 0 0 0 0 0 0 0 0 I 0 0 0 H 0 0 0 0 
0 0 0 0 0 0 0 0 0 0 0 0 0 0 0 0 0 0 0 0 
H H W 0 0 0 W 0 0 0 0 0 0 H 0 0 0 H I 0 
0 0 0 0 W W 0 0 0 0 0 0 0 H 0 0 0 0 I 0 
I W 0 0 0 0 0 0 0 0 H I 0 0 0 0 0 0 0 0 
0 H 0 0 0 0 0 0 0 0 W 0 0 I 0 0 0 I W 0 
0 0 W 0 0 0 0 0 H H H 0 0 I 0 0 0 0 0 0 
0 0 0 I 0 0 0 0 H 0 0 I 0 H 0 W 0 0 0 0 
0 0 W 0 I 0 0 0 0 0 0 0 0 H H 0 0 0 0 0 
0 0 0 0 0 0 H 0 I 0 H 0 0 0 0 0 0 0 0 0 
0 0 0 0 0 0 0 0 0 0 0 0 0 0 0 0 0 0 0 0 
0 0 0 0 0 0 0 0 0 0 0 0 0 0 0 H H 0 H H 
0 0 0 0 0 0 0 0 0 W 0 0 0 0 0 0 W 0 0 0 
0 0 0 I 0 W 0 0 0 0 0 0 0 0 0 0 0 W 0 0 
0 0 0 0 I 0 0 0 0 0 0 0 0 0 0 0 0 0 0 0 
