10
H 0 H 0 0 I 0 0 0 I 
0 0 0 0 0 0 0 0 0 0 
0 0 0 0 0 0 0 0 W 0 
0 0 I 0 0 0 0 0 G W 
0 H 0 0 0 0 0 0 0 0 
0 I 0 0 H 0 0 0 0 S 
H 0 H 0 H 0 0 0 0 0 
H H 0 0 0 0 0 0 W 0 
0 0 0 I 0 0 0 0 0 0 
0 0 I 0 W 0 0 I 0 0 
