10
0 H 0 0 0 I 0 H 0 0 
0 0 0 G S I 0 0 0 W 
0 0 0 0 W H 0 0 0 0 
0 0 W H 0 0 0 0 0 0 
0 0 0 0 0 H H 0 0 0 
0 H 0 W 0 0 0 0 0 0 
0 0 0 0 0 0 0 I H W 
0 W 0 0 0 0 W I 0 0 
0 0 0 0 0 0 0 0 0 0 
W 0 0 0 H 0 H I 0 0 
