5
0 0 H 0 0 
0 0 W S H 
0 0 0 0 G 
0 0 0 H 0 
0 0 0 0 W 
