20
0 0 0 0 0 0 0 0 H I 0 0 0 0 0 0 I 0 0 H 
0 0 0 0 0 0 0 0 0 0 W 0 0 0 H 0 0 0 0 W 
0 0 0 0 I 0 H 0 0 0 H 0 0 0 0 0 0 0 0 0 
0 0 0 0 0 0 0 0 0 0 0 W H 0 0 0 I 0 0 0 
0 0 0 0 0 0 0 0 0 I 0 0 0 0 H 0 0 0 0 0 
0 0 H 0 0 0 0 0 0 0 0 0 0 0 0 0 0 0 0 0 
0 0 0 0 0 H W 0 0 0 0 0 0 0 0 0 0 0 0 0 
0 H 0 0 0 0 0 0 0 W 0 0 0 0 0 0 W 0 0 H 
0 0 0 0 0 0 0 0 0 0 0 0 0 0 0 0 0 0 0 0 
0 0 0 0 0 0 0 0 0 0 0 0 0 0 0 0 0 0 0 0 
0 H 0 0 0 0 0 0 0 0 0 0 0 0 0 0 0 W 0 0 
S 0 I 0 0 0 0 0 0 0 0 0 0 0 0 0 0 0 0 W 
0 0 I 0 W 0 0 0 0 W 0 0 0 0 0 0 0 0 0 0 
I 0 0 0 0 0 0 0 I 0 0 0 I 0 0 0 0 I 0 0 
0 0 0 0 W 0 0 0 0 0 0 H 0 0 0 I 0 0 0 0 
0 0 0 0 0 0 0 0 0 0 0 0 0 0 0 0 0 I 0 0 
0 W 0 I 0 W 0 H 0 0 0 0 0 0 0 0 0 0 0 0 
H 0 0 0 0 0 0 0 0 0 0 0 0 0 0 0 G 0 0 0 
0 0 0 0 0 I H 0 0 I 0 0 W 0 0 0 0 0 W I 
0 0 0 0 0 I 0 0 I 0 0 0 0 0 0 H 0 0 0 0 
